-9
9
-6
5
0000000000000000000
1111111000000000000
1111111000000000000
1111111000000000000
1111111000000000000
1111111000000000000
0000000000000111110
0000000000000111110
0000000000000111110
0000000000000111110
0000000000000111110
0000000000000111110
